1
6
235
██████╗░██████╗░  ██████╗░██╗░░░██╗███╗░░██╗░██████╗░███████╗░█████╗░███╗░░██╗
╚════██╗██╔══██╗  ██╔══██╗██║░░░██║████╗░██║██╔════╝░██╔════╝██╔══██╗████╗░██║
░█████╔╝██║░░██║  ██║░░██║██║░░░██║██╔██╗██║██║░░██╗░█████╗░░██║░░██║██╔██╗██║
░╚═══██╗██║░░██║  ██║░░██║██║░░░██║██║╚████║██║░░╚██╗██╔══╝░░██║░░██║██║╚████║
██████╔╝██████╔╝  ██████╔╝╚██████╔╝██║░╚███║╚██████╔╝███████╗╚█████╔╝██║░╚███║
╚═════╝░╚═════╝░  ╚═════╝░░╚═════╝░╚═╝░░╚══╝░╚═════╝░╚══════╝░╚════╝░╚═╝░░╚══╝